NO  ./textures/brick1.png
WE  ./textures/brick2.png
EA  ./textures/brick3.png
SO  ./textures/brick4.png


F 220,100,0
  C    225  ,  30,  0

111111111111111111111111111111111
11W111110000000001100000000000011
111111111011000001110000000000001
111110010000000000000000000011111
111111111011000001110000000000001
100000000011000001110111100111111
111101111111110111000000100011111
111101111111110111010100100011111
11000000110101011100000010001111
100000000000000011000000100011111
100000000000000011010100100011111
11000011110101011111011110N1111
1111011 1111010111011110100011111
1111111 1111111111111 11111111111
