F  1, 	1 ,	1
C		 225	,	30  ,	0
NO ./path_to_the_north_texture
WE	 	./path_to_the_west_texture
EA ./path_to_the_east_texture
S  	 	./path_to_the_sprite_texture
SO ./path_to_the_south_texture

R  200	    120

11111111
10000001
10000001
10000N01
10000001
11111111
