F  1, 	1 ,	1
C		 225	,		30  ,	0
NO ./Users/yuliia/Codam/textures/1.jpeg
WE	 	./Users/yuliia/Codam/textures/2.jpeg



EA     ./Users/yuliia/Codam/textures/4.jpeg
SO ./Users/yuliia/Codam/textures/1.jpeg


11111
10001
10N01
10001
11111
